R 200 700
SO assets/block/acacia_log.png
WE assets/block/andesite.png
NO assets/block/acacia_log_top.png
EA assets/block/blackstone.png

S ./assets/action.xpm
F assets/block/acacia_log_top.png
C 200,200,255,42

111111111111111111111111111111111111111111111111111111111
100000000000000000000000000000000000000000000000000000001
100000000000000000011111111111111111111110000000000000001
100000000001111111100000000000001111111100000000000000001
100000000111111000000000000000000000110000000000000000001
100000011001100000000000000000000000001100000000000000001
100000100010000000000000000000000000000011000000000000001
100000100110111110000000000011111110000000100000000000001
100001001000010001000000001100110001100000100000000000001
100110001000000001001111001000000000101110111100000000001
101000001011111111110000111111111110011000000100000000001
110000001000001110000000000111111000000000000100000000001
100000001011110000100001100000000011010000000011000000001
100000000010000000000000000000000001001000000000100000001
100000000011000000000000000000000110001000000000010000001
100000000001000000000000000000001000101000000000001100001
1000000000110000000N0000000000001111001000000000000010001
110000000100000000000000000000001100001000000000000001001
101010011100000000000000000000000100001000000000000001001
100100100100000000000000000000000100000100000000000001001
101001000100000000000000000000000100000010000000000010001
110001000000000000000000000000000100000001100000001100001
100000100100000000000000000000001100000000011111111111101
100000011100000000000000000000110000000000000111100000101
100000000111000000000000000111000000000000000100000000101
100000000000111111111111111000000000000000000100000011001
100000000000000000000000000000000000000000000100001100001
100000000000000000000000000000000000000000001000110000001
101000000000000000000000000000000000000000010011000000001
100100000000000000000000000000000000000000101100000000001
100011000000000000000000000000000000000001110000000000001
100000110000000000000000000000000000000110000000000000001
101110001111100000000000000000000001111111000000000000001
111000000000011111111111111111111110000000110000000000001
100111111101000000000000000000000000000000000000000000001
111111111111111111111111111111111111111111111111111111111