R 960 540
SO assets/block/acacia_log.png
WE assets/block/andesite.png
NO assets/block/acacia_log_top.png
EA assets/block/blackstone.png

S ./assets/action.xpm
F 220,100,0
C 225,30,0

1111111111
1000000001
1000001001
10N0000001
1000000001
1000000001
1111111111
