R 1920 1080
SO assets/block/acacia_log.png
WE assets/block/andesite.png
NO assets/block/acacia_log_top.png
EA assets/block/blackstone.png

S ./assets/doom.xpm
F assets/block/acacia_log_top.png
C 200,200,255,42

1111111111
1000000001
1000001001
10N0200001
1000001021
1222000101
1111111111
