R 1080 720
NO ./assets/action.xpm
SO ./assets/action.xpm
WE assets/action.xpm
EA assets/action.xpm
S ./assets/action.xpm
F 220,100,0
C 225,30,0
         1111111111111111111111111 0
         1000000000110000000000001
         1011000001110000002000001
         1001000000000000000000001
 111111111011000001110000000000001
 100000000011000001110111111111111
 11110111111111011100000010001
 11110111111111011101010010001
 110000001101010111000000100011
 10002000000000001100000010001
 10000000000000001101010010001
 11000001110101011111011110N01110000000
 11110111 1110101 101111010001
 11111111 1111111 111111111111
                                                


